11101010111010101010101010111011101011101010101010101110111011101010101010101010111010101010111010101010101110111010101
01011111010111011111111111011101010101011111110111110111010101011111111111111101110111110111011101111111110101010111110
11111011111110111011101011101110111111111010101110111011111110111110101011101110101011101111101011101010111111111011111
01010101011101110101011101110101110101110111111101011101010111110101111101010111111111011101111111011111110111011101010
10111111111011111110111110111110111110111111101011111011111010111110111111111010101110111110101010101110101110101110111
11111101010111010111110101110111010111010101011111010111011111010111010101011111110101110101111111110101111101111111010
10101011111011111011101110111011111111101110111110111011101011101011111111111010111011101010101011101111101010101011111
01110111010101011101110111011101110101111111010101011101011111111101010101010101111111111111110111011101011111111101010
11111010111111101110101110101110111110111011111111101111101010101011111010111110101010101011101110111011101010111110111
01011111110101010111110101110111010101010101010101111101011111111111011111111111110111011101111101110111111111010111110
10111010101111111110101110111011101111101111111110101111101110101011101110101110111110111011101111101110101011101110111
11010111111101011101111111011111111101111101010111110101110101111111110101110101011101111101010101011101110111011101010
11111110111011101110111011101010101011111011101010111111101011101010111011111011101110101110111011111111101110111011111
01011101010111110111010101111111011111010111111111110101111111011111010111011111110111110111111111010101010101110111010
11111011101110111010111111101011101011111011101011101110101010111010111011101110111011101110101010111111111111111110101
01010111111101011101110101010101111101011101011101011111111111110111111101010101011101011101111111110101011101010111111
11101110101011101111101111111111101111101110111011101110101010111111101111111111101011101111101110101011101110111010101
01111101111111110101011101110111010101011111110111110101110111110101010101011101111111010101010111111101110111011111110
10101110111010111111111010101110111011101011101110111110111010101110111111111011101011111110111010101111111010101110111
01110101010101110101011111110101111111010111011101010111011111111101110101010111011101010111111111110101011111111101010
10111111111111101111101011101110101111111011111011101110111011101011111111111111111110111010101110111110101011111011101
11010111011101011101011101111111010101011101011101111101110101011111010101010101010111111101110101110111111101010111110
10111110111011111011101111101011111110111111101011101011111110111010111110111111101010111111101111101110101110111011111
01110101110111010111111101011101110101110101111101011111010111111101110111010101111111010101110101011101011111011101010
11101011101010111010101111101110101111101110101011101110101010101011101011111110101110111110111011111111101011111111101
01111111011111111111110101110111111101110111111101110111011111111101011111010111010101110111011111010101111101010101011
10101111111010111011111110111011101011101011101110111011111011101011101010111011111111101011101011111111101110111111111
01110101010111010101010101111101011111010111010111011101110101111111111111111101010101110101111101010101010111110101010
11111110111111101111111110101111111010111110111011101110101110101110101110101011111110101110111111111011111010101111101
01010101110101111101010111011101011101110101111101110111111111110101110101111111011111111111010101011101111101011101110
10111110101111101011101010111011101011101111101110111110101010111111111110101011101010101111101111101111101111101111101
11110101111101011111111101110111111101111101110111010111110111110101010111110101110111010101110101110101010111010101011
10101111101111101010101111101111101011101110101011111010101110101111101110111110111011111010111110101111111011111111101
01111101010101111111110101011101011111010111110111011101111101111101011101011101011101011111010111111101011101110101110
10111011111110101011111111111011101111111010111110111011101111101111101111101111101111101011111011101110111010101111101
01011111010101011101010111010101110101011101110101111111010101010101110101110111110101111101111101011111011111011101011
11101010111111111011111010111111101111101110111110111010111111111011111111111010101110111110101011111010111011111011101
01111111110101011101011111110111011101110111010111010111110101011111010101011101111111010111111111010111110101110111111
11101011101111101110101011101010101011111110111111111110111011111010101111101111101110101110101110111011111110111110101
01111101011101110101111111011111111101010101010101010111011111011111011101010101010111110111010101011101010111010101110
10101111111111101111101010111010111111111111111111111010101011101011101111111011111011101010111111101010111110111010111
11110101010101011101011111110111010101010101110101011111111101011101110101011111011101111111110111111111110101111111110
10101111111011101111101110111011111010111110111011101010101111111110111111111010111110101110111010101011101111101010101
01111101011101110101110111011101011111010111011101111111110101010111010101110111110111110111011111111101011101110111110
11101011101110111110111110111011101011111011101011101011111011101111111011101110101011111011101110111011111110101110111
01110111110111010111010101010111111101111101111111010101011111110101010111011111110101011101010101110111010111111101110
10101110101111111011111011111010111110111011101110111110101010111011111110111011101110111011111011101110111010101011101
11110101111101011101111111011111010111010111110101110111111111011111011101110101011111110111011101011101010111110101011
10111110101110111110101011111011111011111011101111111011101110111011111011101110111010111111101111101111111110101111111
11010111110101110111110111011101011101011101011101011101010101110101010111110111010111010101010111110101011101111111010
10111011101110111010111011101111101111101011101010101111111110111110111010111111111110101110111010101111101111101010111
01011101011111010111011101110101110101111111011111110101010111010111011111010101010111111101111111111101110101011111010
11111011111011101111111110101010111010111110111110111111111011111011101011101110111110101110101010101110111110111011101
01110111010101111101010111111111111111010101110101011101110111010101011111111101110101110111111111110111010111110101111
10111111111110111011101110111010111010111111101111101011101110111111111010101011111011111110101010111111111010111111101
11010101010111011101110101110111010111110101110101111111011101111101010111111111011111010111011111110101011111010101010
10111111101111101110101111101111101110101010101110111010101010111011111010111010101010111011101011101111101111101111111
01110101111101110111011101011101111111111111011111011111111111010111111111011111111101011101110101011101110101111101010
10111010111010111011101011101010101010111011111011101011101110101110101011101010111011101110111111111110101110101110111
11011111010111011101111101111111111111010101110101111101010111111101010111111111010111111111010101010101111111110111110
10111010111011111011101110111010111010111110101110101110111011101011111110101110111110101010111110111010101010101111101
01110111111101010111010111010101110111110111111111110111011101011111011101110101110101111111110111111111111111110101011
10101110101111111110111110111110111010101110111010111011101110101011101010111111101111101110111011101010101110101011101
01111111010111010101011101111111011111111101010101011101011111111111011111110101110101010111011101011111110111111111110
10111010111011111111111011101011101110101111101111101111111010111011101110111010111110111011101110111010111110101010101
11010101111101010101110111110101110101011101111101111101110111010101110101011111010111111101110111010111010101111111110
11111110101110111110101110101111101111101011101110101011101110101111101111101011111010101110111011111111111110111010111
01010111110111010111110101111101011101111111010111111111011111111101111101111101011111110111010111010101010111011101010
11111010111110111010111011101110111011101110111010101010111010111010101011101111101010101110111010111011111010111011111
01011111110101111111011111010111010111010101011101111111110111011111110111010101111111110101111101111101011111110101110
10111011101111101111101110111110111110111111101111101010101111101011101110111111101011111110101110101111111010101111101
01110101011101010101110101110111110101110101110101011111111101111101111101110101011101010111110111111101011111011111011
11101111111010111011101110111010101110111110111111111010101010101110101011101111111011111010111011101011101011101010101
01011101011111011111011111011111111101011111010111010111111111110111111111011101010111011111011101011111111101011111111
10111111101011111011101110111010111011101011111110111110101010111010101011101110111011111011101111101110101111111010101
11110101111101110101110101111101110111110111010101111101111111010111111101110111111101010101110101110111110101110111110
11101011101110101110111110101110101110111010111011101011101110111110101111111011101011101110101110101011101110111110111
01011111010111111111010111110111111101010111111111011111010101110101110101011101011111111111110111111101011111010101110
11101110111010101011111110111010101011111010101010111010111110111110111011101111101110101010111110111010111011111011101
01110101111111111101010101011111111111011111111111111111011111010111011111011101110101011111011101011111110101011101010
10111111111011101011111011101011101010111010101010101011111011111011101010111011101111111010111011101010111111101011111
01110101010101011111011111110111011111111111111111110101010101011101110111110111011111010111110111111111010101111111011
10101011111111101010111010111011101110101110101010101110111111111011101110101110101010111010101110101011101110101011101
11111111010101111111011101111101110111010101111111011111110101010111110101111111111111011111011111111101111111111101010
10101110101110101010111011101011111010111111101110111011101111111010111110101110111010111011111010101110101010101111111
01110111111111111101110111011101011111110101010101110101011101011111011111110101011111110101010111110101111111010101110
10111010111010101110111011111010101011101111111110111110111011101011101110111011101010101111111111101110101110111110101
01011111010111110111011101010111111111011101010101110111110111111101110101011101111111011101110101011101111101111111110
11101110111011111011101011111011101010111011111111101010111010101111101111101110111011101110101011101111101011101010111
11110101111101011101111101011101011111110111010111011111111101111101010101110111110101111111111111110111011101011101110
10101111101011101110111011101111111010101110111011101110101110101010111111111010111110111010101010101110111111101110101
01111101011111010111011101110101010111110101111101110101110111110111111101011111010111010111111111111101110101110111111
11101111111011111011101111101111111111101111111011101110111010111111101011111011101111101110101010101111101110111010101
01010101010101011101110111011101010101011101010111011111011111010101011111010101111101111101111111110101010101111111110
10111111111110101110101010111011111111101011111011111011111010111011111010111110101010101011101010111111111011101010101
01110101011111111101111111111111010101111111011101010111010111111111010111010111111101111111110111010101011111011111111
11111110111010101110101110101010111010111010101111101110111010101010111011101110101110111010111110111011111110111010101
01010111010111110111111101111111111111011111010101011101111111111111111111111101110111010101010101111111010101111111010
10111110111110111010101011101010111010111010111110111011101110101110101010111011101110111111111111101011111110101110111
11010111110101011111111111111101011111010111110111110111010101110111011111010111011101110101010111010101010111110101111
10111010111111101110101010101011101011111010111110111010111010111011111010111110101011101111101110111111101111101110101
01111111010101011101111101111111111101011111010101011111111111111101011111010111111111110101111101110111110101011111110
10111011101111111011101110111010101111101010111111101110111010101011111011101110101110111110101110111010111111101110101
11010101111101110111110111010111010101111111110111010111010111111111010101011101110101010111110111011101110101110101110
10111110101011101110101011111011111110111010111010111110111110101010111111111011111111111010111011111110111110111111111
01111111111101011111011101011111011111011101011111110101110101111111110101110111010101011111010111010111010101110101010
11101010111011101110111011111011101110111011101010111111101110101110101111101110111011111011111010111011111110111011111
01110111010111110101011111010101010101110111011111110101011101110101111101011111011111010111011111110101010111011111010
10111110111010111011111011101111111011101011111011101111101111111110111011101110101011111010111011101111111110101011101
11010101110111011111010101011101011111011101110101011101110101010101110111110101111101011101110101110111010101111101011
11101111101111101010111111111111111010111011101110101011101110111111101110111111101111101110101110111011101110111011111
01111101110101111111110101010101011111110111011111011111011111110101011101010101010111110111111111011101111101011111010
11101110111110101110101111101111111010111011111011111011101010111011111011111110111010111010111011111010101111101011111
01010111010111010101111101111101010111011101010101110101111111010111010111010101111101011111010101010111110111111101010
10111110111010111111101011101111101111101110111110111111101010111011101111101110101111101011111110111110111110111011101
01110101111111110101011111010101111101110111110111010101011111111101111101111111111101011111011111010101010101010111110
11111111101010101111111010111110111010111010101110111111101110101011101110111011101011111010111011101111101011101110101
01010101111111111101011101110111010111111111111101110101110101111111010101010101011111010111110101111111111111111101111
10111010101010101011101011101010111010101010101010101110101110101010111011101110111010111010101110101010101010101010101
